aamiiin	amin
aamiin	amin
ababil	abg labil
abis	habis
about	tentang
acc	accord
accord	sesuai
ad	ada
adl	adalah
adlah	adalah
adlh	adalah
adoh	aduh
ae	saja
afaik	as far as i know
agr	agar
ahaha	tertawa
aha	tertawa
ahlinye	ahlinya
aing	saya
ajaa	saja
ajah	saja
aja	saja
aje	saja
ajj	saja
aj	saja
aka	dikenal juga sebagai
akhirx	akhirnya
akika	aku
akir	akhirat
akko	aku
akkoh	aku
akku	aku
akn	akan
ak	saya
akutuh	aku itu
akuwh	aku
akyu	aku
alay	norak
alesannya	alasannya
alhasil	hasilnya
aljasa	asal jadi saja
alloh	allah
alow	halo
amann	aman
ama	sama
ambilin	ambilkan
ambl	ambil
ameh	mau
amerik	amarika
ampe	sampai
amplifying	memperkuat
analisise	analisis
ancur	hancur
and	dan
angell	susah
angel	susah
angis	nangis
anjay	anjing
anjg	anjing
anjim	anjing
anjir	anjing
anjirrr	anjing
anjirrrr	anjing
anjr	anjing
anjrit	anjing
ank	anak
anter	antar
anw	ngomong ngomong
any	ada
anying	anjing
anyinggg	anjing
apaaaa	apa
apaan	apa
apabedanya	apa bedanya
apalg	apalagi
ap	apa
apasih	apa sih
ape	apa
apes	sial
aplot	unggah
aps	apa
apva	apa
aq	saya
aqu	aku
aquwh	aku
ar	air
as	amerika serikat
asbun	asal bunyi
aseek	asyik
aseekk	asyik
asek	asyik
asekk	asyik
aseknya	asyiknya
asem	asam
ask	bertanya
asoy	asyik
aspal	asli tetapi palsu
astrojim	astagfirullahaladzim
astul	asal tulis
asuu	anjing
atasnama	atas nama
ath	kalau begitu
ato	atau
atuh	kalau begitu
atw	atau
au ah	tidak mau tahu
ava	avatar
awake	badannya
awak	saya
awale	awalnya
award	penghargaan
aws	awas
ayank	sayang
ayok	ayo
ayoo	ayo
ay	sayang
back	kembali
bacot	banyak bicara
bacothhhshshjdsjsb	banyak bicara
bad	salah
baheula	dahulu
bajer	anjing
bajir	banjir
bakal	akan
bakalan	akan
bales	balas
bandes	bantuan desa
bang	abang
bangedh	banget
bangkotan	tua
bangunin	bangunkan
bansos	bantuan sosial
bantuane	bantuannya
banyk	banyak
basbang	basi
bat	banget
bawain	membawakan
bawel	cerewet
bawell	cerewet
bayangin	membayangkan
bbrpa	beberapa
bbrp	beberapa
bcanda	bercanda
bcoz	karena
bebal	bodoh
beb	sayang
bedaaa	beda
bedakin	bedak
begajulan	nakal
bego	bodoh
begonya	bodohnya
bejibun	banyak
beliin	belikan
be like	ibarat
belom	belum
benarjujur	benar
bencong	banci
benefit	keuntungan
benefitnya	keuntungannya
bener	benar
benerr	benar
bengek	hal
bentar	sebentar
berdikari	berdiri di atas kaki sendiri
beresin	membereskan
beres	selesai
berharaf	berharap
berika	berikan
bet	banget
bete	bosan
beti	beda tipis
beud	banget
beut	banget
bg	abang
bgd	banget
bgmm	bagaimana
bgmn	bagaimana
bgs	bagus
bgst	bangsat
bgt	banget
bharap	berharap
bhkn	bahkan
bhubu	tidur
bhya	bahaya
biarin	biarkan
biayain	biaya
bijimane	bagaimana
bintk	bintik
bkerja	bekerja
bkin	bikin
bkl	akan
bkn	bukan
bknnya	bukannya
bl	beli
blegug	bodoh
bleh	boleh
blg	bilang
blh	boleh
blm	belum
bln	bulan
blng	bilang
blom	belum
bls	balas
blum	belum
bnchi	benci
bnci	benci
bngung	bingung
bnran	yang benar
bnyk	banyak
bo	dibawa keluar
bodor	lucu
body	badan
bohay	badan aduhai
bokap	ayah
bokep	porno
boker	buang air besar
bokin	pacar
bokis	bohong
bole	boleh
boljug	boleh juga
bolot	bodoh
bonek	bocah nekat
boring	bosan
boro	jangankan
boyeh	boleh
bpk	bapak
brbagai	berbagai
br	baru
brbayar	berbayar
brbeda	berbeda
brb	segera kembali
brg	bareng
brmanfaat	bermanfaat
brngkt	berangkat
bro	saudara laki laki
brp	berapa
bru	baru
brur	saudara laki laki
bsa	bisa
bs	bisa
bsen	bosan
bsk	besok
bt	bosan sekali
btw	ngomong ngomong
buatny	buatnya
buaya	tidak setia
bubarin	bubarkan
bubbu	tidur
buber	buka bersama
bubu	tidur
bujubune	luar biasa
bumil	ibu hamil
bun	bunda
bund	bunda
buser	buru sergap
bw	bawa
bwhn	bawahan
bwt	buat
byar	bayar
byk	banyak
by	oleh
byr	bayar
byrin	bayarkan
cabal	sabar
cabut	pergi
cadas	keren
caem	cakep
cakap	bicara
calo	makelar
cama	sama
can	belum
capcus	pergi
cape	capek
caur	jelek
cayalah	percaya
cb	coba
ce	cewek
cekak	tidak ada uang
cekal	cegah tangkal
cekidot	coba lihat
cemen	penakut
cemplungin	cemplungkan
cengengesan	tertawa
ceper	pendek
cepet	cepat
ceu	kakak perempuan
cew	cewek
cewe	cewek
china	cina
choice	pilihan
chuyunk	sayang
cibuk	sibuk
cimeng	ganja
cin	cinta
cipika cipiki	cium pipi kanan cium pipi kiri
ciye	cie
ckepp	cakep
ckp	cukup
clinical	klinik
cm	cuma
cmiiw	terima kasih
cmn	cuma
cmpr	campur
cnenk	senang
comeback	kembali
come on	ayo
coming	datang
cong	banci
congor	mulut
conlok	cinta lokasi
country	negara
cow	cowok
cowwyy	maaf
coz	karena
cpa	siapa
cpe	capek
cppa	siapa
cppe	capek
cp	siapa
cpt	cepat
cr	cara
cs	dan teman teman
cucok	cocok
cuex	cuek
cuman	cuma
cumi	cuma miscall
cungkring	kurus tinggi
cups	culun
cupu	culun
curanmor	pencurian kendaraan bermotor
curas	pencurian dengan kekerasan
curcol	curahan hati colongan
curhat	curahan hati
cwek	cewek
cwok	cowok
cyin	cinta
cz	karena
daahh	sudah
daan	dan
dadi	jadi
dagh	sudah
dahal	padahal
dah	sudah
dakwan	dakwaan
damang	sehat
dancuk	anjing
dapet	dapat
dapett	dapat
dapettt	dapat
dateng	datang
d	di
de	adik
dech	deh
degan	dengan
dek	adik
deket	dekat
deketin	mendekati
demen	suka
denger	dengar
dengerin	dengarkan
develop	pengembang
dewe	sendiri
deyh	deh
dg	dengan
dgn	dengan
dh	deh
dhemit	iblis
diancurin	dihancurkan
dibeliin	dibelikan
dibri	diberi
didnt	tidak
diem	diam
digosipin	digosipkan
digratisin	digratiskan
dihrpkan	diharapkan
dikasi	dikasih
dikit	sedikit
dimaafin	dimaafkan
dimintak	diminta
dimna	dimana
dinekin	dinaikan
disono	di sana
diuber	dikejar
dket	dekat
dkk	dan kawan kawan
dl	dulu
dll	dan lain lain
dlm	dalam
dluan	duluan
dlu	dulu
dmn	dimana
dm	pesan langsung
dn	dan
dngn	dengan
doang	saja
doctor	dokter
dodol	bodoh
doi	dia
dokterny	dokternya
dokternye	dokternya
doktor	dokter
doku	uang
dolan	main
dongo	bodoh
dongok	bodoh
dongs	dong
don	jangan
don juan	playboy
donlot	unduh
dpn	depan
dpt	dapat
dr	dari
dri	dari
dripada	daripada
dripda	daripada
drmana	darimana
drmn	darimana
drop	turun
drpd	daripada
drtd	dari tadi
dsb	dan sebagainya
dst	dan seterusnya
dstu	disitu
dtg	datang
dudu	bukan
dugem	dunia gemerlap
duh	aduh
duitin	dijadikan duit
duit	uang
duiung	dukung
dungu	bodoh
dunya	dunia
duren	durian
dvaksin	divaksin
dy	dia
dzolim	zalim
ea	ya
edan	gila
ed	edisi
ego	emosi
egp	emang gue pikirin
eike	aku
eke	aku
ekekeke	tertawa
elo	kamu
elu	kamu
emang	memang
emangnya	memangnya
emank	memang
emg	memang
emng	memang
emte	makan teman
endak	tidak
engak	tidak
enggak	tidak
engga	tidak
enk	enak
entar	nanti
envy	iri
even	bahkan
ex	mantan
expire	kadaluarsa
ext	extension
fax	facsimile
fb	facebook
f	fahrenheit
finek	finansial ekonomi
fitnag	fitnah
focus	fokus
follow	mengikuti
for	untuk
free	gratis
fresh	segar
fwd	diterukan
fyi	sebagai informasi
gaada	tidak ada
gabakalan	tidak akan
gabisa	tidak bisa
gada	tidak ada
gag	tidak
gahar	sangar
gajelas	tidak jelas
gaje	tidak jelas
gakan	tidak akan
gak papa	tidak apa apa
gak	tidak
gamampu	tidak mampu
gamao	tidak mau
gamau	tidak mau
gan	juragan
gantengbs	ganteng
ga papa	tidak apa apa
gapapa	tidak apa apa
gaperlu	tidak perlu
gasih	tidak sih
gas	nyolot
gatau	tidak tahu
gatek	gagap teknologi
ga	tidak
gatot	gagal total
gausah	tidak perlu
gawe	kerja
gax	tidak
gbs	tidak bisa
gda	tidak ada
gebetan	orang yang disuka
geer	gede rasa
gegara	gara gara
geje	tidak jelas
gelem	mau
gelo	gila
gemblung	bodoh
gempabumi	gempa bumi
gepeng	gelandangan dan pengemis
gess	teman teman
ghiey	lagi
ghiy	lagi
gi	lagi
gile	gila
gimana	bagaimana
gimanasih	bagaimana sih
giman	gigi mancung
gini	begini
gino	gigi nongol
gitchu	begitu
gitu	begitu
gj	tidak jelas
gk	tidak
gmana	bagaimana
gm	bagaimana
gmn	bagaimana
gn	begini
gni	begini
goblok	bodoh
gokil	gila
golput	golongan putih
gombal	suka merayu
good	bagus
governor	gubernur
gpl	tidak pakai lama
gpny	tidak punya
gpp	tidak apa apa
gretongan	gratisan
gretong	gratis
gr	gede rasa
gtau	tidak tahu
gt	begitu
g	tidak
gtu	begitu
gtw	tidak tahu
gua	saya
gub	gubernur
gue	saya
guoblok	goblok
guys	teman teman
gw	saya
gws	cepat sembuh
haghaghag	tertawa
hahahahahahah	tertawa
hahahaha	tertawa
hahaha	tertawa
haha	tertawa
hakhak	tertawa
hallo	halo
haloo	halo
handak	bahan peledak
hangout	kumpul kumpul
happy	bahagia
hardcore	keras
ha	tertawa
healthy	kesehatan
hehehe	tertawa
hehe	tertawa
hellow	halo
helo	halo
helow	halo
hentikn	hentikan
hep	hepatitis
herman	heran
heter	pembenci
heters	pembenci
hey	hai
hi	hai
hlm	halaman
hlng	hilang
hnw	hidayat nur wahid
hnya	hanya
hny	hanya
hoax	isu bohong
houm	rumah
hr	hari
hrs	harus
hrsnya	harusnya
hrus	harus
hsl	hasil
huft	mengeluh
humoris	lucu
hum	rumah
humz	rumah
hurts	pedih
hy	hanya
idioters	orang idiot
idiots	idiot
idk	saya tidak tahu
idup	hidup
ig	instagram
iki	ini
ikon	lambang
ilang	hilang
ilfeel	tidak suka
ilfil	tidak suka
imba	jago sekali
imoet	imut
imoetz	imut
ind	indonesia
indo	indonesia
info	informasi
inget	ingat
inmbasnya	imbasnya
insom	insomnia
insonesia	indonesia
irit	hemat
i	saya
isengin	bercanda
issue	isu
istaa	nista
ista	nista
item	hitam
itungan	hitungan
itung	hitung
iyala	iya lah
iye	iya
iy	iya
iyo	iya
jablay	jarang dibelai
jadiin	jadikan
jadul	jaman dulu
ja hat	jahat
jaim	jaga image
jak	seperti
jancuk	anjing
jangaaaannn	jangan
jan	jangan
janjinyaa	janji
ja	saja
jatoh	jatuh
jayus	tidak lucu
jdi	jadi
jdikan	jadikan
jd	jadi
jeas	jelas
jem	jam
jentelmen	berani
je	saja
jga	juga
jg	juga
jgn	jangan
jgnkan	jangankan
jijay	jijik
jir	anjing
jk	jika
jkt	jakarta
jng	jangan
jngn	jangan
jnj	janji
jomblo	tidak punya pacar
jth	jatuh
jt	juta
jubir	juru bicara
jurdil	jujur adil
jutek	galak
jwb	jawab
kabag	kepala bagian
kab	kabupaten
kabor	kabur
kacian	kasihan
kacrut	kacau
kades	kepala desa
kadoin	kado
kadoinnya	kadonya
kagak	tidak
kaga	tidak
kaka	kakak
ka	kepala
kalaiin	kalian
kalo	kalau
kalok	kalau
kampret	sialan
kamuh	kamu
kamuwh	kamu
kamyu	kamu
kang	kakak laki laki
kann	kan
karean	karena
karna	karena
karo	dengan
kasian	kasihan
kasi	kasih
katrok	kampungan
katut	terbawa
kau	kamu
kayanya	kayaknya
kbar	kabar
kbenaran	kebenaran
kbr	kabar
kbutuhan	kebutuhan
kcian	kasihan
kdu	harus
keburu	terlanjur
kec	kecamatan
kedetect	terdeteksi
keep	menjaga
kekeuh	keras kepala
keknya	kayaknya
kek	seperti
kelelep	kelalap
keliatan	kelihatan
kel	kelurahan
kemajan	termakan
kemaren	kemarin
kendor	kendur
keneh	masih
kenek	kena
kenk	kena
keno	kena
kentot	sanggama
kepengen	mau
kepikiran	terpikirkan
kepingin	mau
kepo	mau tahu urusan orang
kepriye	kenapa
kere	tidak punya uang
kesbang	kesatuan bangsa
kesetanan	kesehatan
kesian	kasihan
ketauan	ketahuan
ketrima	diterima
keukeuh	keras kepala
kgiatan	kegiatan
kgk	tidak
khan	kan
kibul	bohong
kibus	kaki busuk
ki	ini
kimpoi	kawin
k	ke
k	ke
kk	kakak
klian	kalian
klianz	kalian
kl	kalau
kl	kalau
klo	kalau
klo	kalau
kloter	kelompok terbang
kluarga	keluarga
klu	kalau
klw	kalau
klw	kalau
klwrga	keluarga
kmari	kemari
kmdian	kemudian
km	kamu
kmna	kemana
kmps	kampus
kmpus	kampus
kmren	kemarin
kmrm	kemeramen
kmrn	kemarin
kna	kena
knal	kenal
kn	kan
knl	kenal
knpa	kenapa
knp	kenapa
kocak	lucu
koe	kamu
kog	kok
koit	mati
ko	kok
kolrktif	kolektif
kompi	komputer
konco	teman
kon	disuruh
kongkow	kumpul bareng teman
kopdar	kopi darat
koq	kok
korona	corona
korup	korupsi
kotori	mengotori
kovid	covid
kowe	kamu
koyongene	seperti ini
kpd	kepada
kpn	kapan
kptsan	keputusan
krenz	keren
krik	garing
krim	kirim
krm	kirim
krna	karena
krn	karena
ktauan	ketahuan
ktipu	tipu
kt	kita
ktmu	ketemu
ktny	katanya
ktr	kantor
kualitaz	kualitas
kudu	harus
kui	itu
kuper	kurang pergaulan
kuq	kok
kurng	kurang
kuy	ayo
kw	imitasi
kyak	kayak
kykny	kayanya
kyk	seperti
kynya	kayaknya
laka	kecelakaan
la	lah
lambreta	lambat
lamp	lampiran
lam	salam
lansia	lanjut usia
lbh	lebih
lbur	libur
lebay	berlebihan
lebel	label
leh	boleh
lelet	lambat
lemot	lambat berfikir
less	kurang
let	membiarkan
lgi	lagi
lgkp	lengkap
lg	lagi
lgsg	langsung
lht	lihat
life	kehidupan
light	terang
lmyn	lumayan
lngkp	lengkap
loch	loh
loe	kamu
lo	kamu
lokdwon	lockdown
lola	lambat berfikir
lol	tertawa
lom	belum
long	panjang
louph	cinta
loupz	cinta
love	cinta
lowh	kamu
low	kalau
lp	lupa
lps	habis
luchuw	lucu
luff	cinta
luh	kamu
lu	kamu
lula	lupa
lum	belum
luph	cinta
luthu	lucu
lw	kamu
lwn	lawan
lwt	lewat
m	3m
maaciw	terima kasih
maap	maaf
mabal	bolos
mabes	markas besar
macem	macam
macih	masih
madesu	masa depan suram
maem	makan
maen	main
maennya	mainnya
mahatma	maju sehat bersama
mahl	mahal
maho	homo
makasih	terima kasih
makenya	pakainya
make	pakai
mak	ibu
mak jang	kaget
maksain	memaksa
maksa	paksa
maksutnya	maksudnya
malah	bahkan
males	malas
malh	bahkan
mam	makan
mampus	mati
mamz	makan
maneh	lagi
manen	panen
manfaatin	manfaatkan
manggil	panggil
manies	manis
mank	memang
mantaaaapppp	mantap
mantabss bagus	
mantep	mantap
manut	patuh
mao	mau
marai	membuat
mare	besar
markus	makelar kasus
masak	masa
masalh	masalah
mash	masih
masii	masih
masi	masih
maslh	masalah
masukin	masukkan
masy	masyarakat
mauuu	mau
mayar	bayar
maybe	mungkin
mbabibuta	ceroboh
mba	mbak
mbaur	baur
mb	mbak
mborong	borong
mbual	bual
mcm	seperti
melu	ikut
membahyakn	membahayakan
mendapatka	mendapatkan
mending	lebih baik
meneh	lagi
mengehentikan	menghentikan
mengeklaim	mengklaim
menjd	menjadi
menjlaani	menjalani
menolak	tolak
mensupport	mendukung
mepet	dekat sekali
met	selamat
mgkin	mungkin
mgkn	mungkin
mgu	minggu
mhn	mohon
migas	minyak dan gas bumi
miker	minuman keras
mikol	minuman beralkohol
milis	mailing list
min	minimal
miras	minuman keras
miss	kangen
mjadi	menjadi
mkn	makan
mksd	maksud
mlah	malah
mlh	malah
mlu	melulu
mlwan	melawan
mmg	memang
mmng	memang
mnding	lebih baik
mndukung	mendukung
mnipu	tipu
mnjadi	menjadi
mnolak	tolak
mnt	minta
modar	mati
moga	moga
moge	motor gede
mohon	mohon
mokad	mati
mo	mau
mosok	masa
moso	masa
most	paling
mpe	sampai
mreda	mereda
mreka	mereka
mrk	mereka
msh	masih
msk	masuk
mskpn	meskipun
mslh	masalah
mt	makan teman
muahal	mahal
mudahan	semoga
muji	memuji
mulu	melulu
mumet	pusing
mumpung	selagi
muna	munafik
munfik	munafik
muntaber	muntah dan berak
murahhhhhhh	murah
musti	mesti
mute	bisu
muup	maaf
muupz	maaf
muuv	maaf
mw	mau
my	saya
mz	mas
naas	nahas
nabung	tabung
naha	kenapa
nak	mau
nal	kenal
nambah	tambah
nambal	tambal
nanam	menanam
nangis	menangis
nanya	bertanya
naon	apa
napa	kenapa
nape	kenapa
napi	narapidana
naq	anak
nasbung	nasi bungkus
nawarin	menawakan
ndak	tidak
ndak	tidak
n	dan
ndang	cepat
nda	tidak
ndek	dari
ndiri	sendiri
ndut	gendut
negoro	negara
negri	negeri
neh	ini
ne	ini
nek	kalau
nelfon	menelepon
nembak	menyatakan cinta
ne	nya
next	lanjut
ngadain	mengadakan
ngadii	mengada ngada
ngadi	mengada ngada
ngakak	tertawa
ngak	tidak
ngaku	mengaku
ngambek	marah
ngambil	mengambil
ngampus	pergi ke kampus
ngantri	mengantri
ngantuk	mengantuk
ngapah	kenapa
ngapain	sedang apa
ngaret	terlambat
ngaruh	berpengaruh
ngasih	memberikan
nga	tidak
ngawur	berbicara sembarangan
ngebandel	berbuat bandel
ngebayangin	membayangkan
ngebuat	membuat
ngebully	intimidasi
ngegosip	bergosip
ngehe	kesal
ngeh	sadar
ngekill	membunuh
ngeklaim	mengklaim
ngekos	tinggal di kos
ngeksis	menjadi eksis
ngelamar	melamar
ngeles	berkilah
ngeliat	melihat
ngelidur	menggigau
ngelola	mengelola
ngemen	bicara terus terusan
ngenal	mengenal
ngene	begini
ngentotin	sanggama
ngentot	sanggama
ngerampok	merampok
ngeri	seram
ngerti	mengerti
ngetes	mengetes
ngewe	bersanggama
nggak	tidak
ngga	tidak
ngg	tidak
ngibul	berbohong
ngikut	ikut
ngiler	mau
nginep	menginap
ngiri	iri
ngisiin	mengisikan
ngisi	mengisi
ngku	mengaku
ngmg	bicara
ngmng	bicara
ngntd	keras kepala
ngobrol	mengobrol
ngocol	lucu
ngomomg	bicara
ngomong	bicara
ngomongin	membicarakan
ngotot	keras kepala
ngubek	mencari cari
ngumpet	sembunyi
ngumpul	kumpul
ngundang	mengundang
ngurus	mengurus
ngutang	hutang
nice	bagus
niech	nih
nie	ini
nih	ini
ni	ini
nimbrung	ikut serta
ningkat	meningkat
nipu	tipu
niyh	nih
njing	anjing
nkah	nikah
nmenarik	menarik
nmn	namun
nmr	nomor
nnti	nanti
nntn	nonton
nobar	nonton bareng
nolak	tolak
nongkrong	kumpul kumpul
no	tidak
np	now playing
nrp	narapidana
ntar	nanti
nt	nanti
ntn	nonton
ntr	nanti
nuhun	terima kasih
numpuk	bertumpuk
nunggu	menunggu
nurun	menurun
nutupin	menutupi
nyaingin	saing
nyalahin	salah
nyalain	menyalahkan
nyambung	sambung
nyampah	membuat sampah
nyang	yang
nyariin	mencari
nyari	mencari
nyasar	tersesat
nyekar	menyekar
nyela	cela
nyembah	sembah
nyemot	ambil
nyerang	serang
nyiapin	mempersiapkan
nyicil	mencicil
nyiram	menyiram
nyoblos	mencoblos
nyokap	ibu
nyok	ayo
ogah	tidak mau
ojo	jangan
okt	oktober
ol	online
omdo	omong doang
ongkir	ongkos kirim
onta	unta
o/	oleh
oon	bodoh
oot	out of topic
opo	apa
optimia	optimis
oraa	tidak
orange	oranye
or	atau
ora	tidak
org	orang
orkes	olahraga dan kesehatan
orng	orang
oroos	peduli
ortu	orang tua
otda	otonomi daerah
other	lain
otre	ok
otw	sedang di jalan
our	kami
pa	apa
pacal	pacar
pahe	paket hemat
pakaii	pakai
pakek	pakai
pakku	bapak aku
pala	kepala
pandemic	pandemi
panja	panitia kerja
pansus	panitia khusus
pantura	pantai utara
paranoid	takut
parno	takut
parte	partai
pastu	pasti
pasutri	pasangan suami istri
patas	cepat dan terbatas
pay	membayar
pdhal	padahal
pdhl	padahal
pd	pada
pede	percaya diri
peju	sperma
pelatda	pemusatan latihan daerah
pembaut	pembuat
pembokat	pembantu
pemda	pemerintah daerah
pemilu	pemilihan umum
pemkot	pemerintah kota
pemprov	pemerintah provinsi
pemred	pemimpin redaksi
pendidikn	pendidikan
penertiban	tertib
pengen	ingin
penjas	pendidikan jasmani
penmas	pendidikan masyarakat
percoyo	percaya
perda	peraturan daerah
perek	wanita tuna susila
perhatiin	perhatikan
pertamax	pertama
pesakit	penyakit
pesenan	pesanan
pesenin	pesankan
pgang	pegang
pgi	pergi
pgn	ingin
pict	foto
pie	bagaimana
piee	bagaimana
pijetin	pijitkan
pilkada	pemilihan kepala daerah
pimpro	pemimpin proyek
pinter	pintar
pisan	sangat
pisgor	pisang goreng
pi	tapi
piye	bagaimana
pke	pakai
pk	penjahat kelamin
pleciden	presiden
plesir	pelesir
plg	paling
plh	pilih
pliss	tolong
plis	tolong
plng	paling
pls	tolong
pm	perdana menteri
pmrinthan	pemerintahan
pmrnth	pemerintah
pndukung	pendukung
pn	mau
pny	punya
po	apa
point	poin
ponsel	telepon seluler
positive	positif
ppa	apa
pp	pulang pergi
prcya	percaya
preorder	pre order
presh	segar
prg	pergi
prikitiw	cie
priksa	periksa
priority	prioritas
prmerintah	pemerintah
prnh	pernah
problem	masalah
pro	profesional
protokoler	protokol
prototype	contoh
prtokol	protokol
psen	pesan
psn	pesan
psti	pasti
pst	pasti
pswt	pesawat
puanas	panas
pulgar	kasar
puyeng	pusing
puyeng	pusing
pw	posisi nyaman
qmo	kamu
qmu	kamu
qt	kita
raketan	rakitan
rak	tidak
rame	ramai
ra sah	tidak perlu
rasah	tidak perlu
rate	rata rata
ra	tidak
rb	ribu
rebu	ribu
reply	balas
re zim	rezim
ri	republik indonesia
rkyt	rakyat
rmbt	rambut
rmh	rumah
room	ruangan
rp	rupiah
rrcina	cina
rs	rumah sakit
rubahnn	rubah
ru	baru
ruz	terus
safe	hati hati
saiank	sayang
saia	saya
salahin	salah
salting	salah tingkah
saltum	salah kostum
salud	salut
sampe	sampai
sampeyan	anda
sampingg	samping
samsek	sama sekali
sapa	siapa
sape	siapa
sapose	siapa
save	jaga
sayan	sayang
say	sayang
sbb	sebagai berikut
sbg	sebagai
sbh	sebuah
sblm	sebelum
sbnrnya	sebenarnya
sbnrny	sebenarnya
scara	secara
scr	secara
sdah	sudah
sdgkn	sedangkan
sdg	sedang
sdh	sudah
sdkt	sedikit
sdngkn	sedangkan
sdng	sedang
seabrek	banyak
sebelas dua belas	mirip
sebelom	sebelum
sedjak	sejak
seger	sehat
seh	sih
sekda	sekretaris daerah
sek	dulu
sekjen	sekretaris jenderal
semau	asal
sembako	sembilan bahan pokok
sembuhin	menyembuhkan
semkin	semakin
sempet	sempat
sendratari	seni drama tari
sept	september
serah	terserah
serasiii	serasi
sertijab	serah terima jabatan
setting	atur
setujuuuu	setuju
setujuuuuu	setuju
sgala	segala
sg	snapgram
sgt	sangat
sgtunya	segitunya
share	bagi
shgga	sehingga
shg	sehingga
shop	shopee
should	sebaiknya
sib	sih
sidak	inspeksi mendadak
siech	sih
sieyh	sih
sikon	situasi dan kondisi
sila	silahkan
simiskin	miskin
simpedes	simpanan pedesaan
sinetron	sinema elektronik
sing	yang
sip	ok
siramin	siramkan
sis	kakak perempuan
sitik	sedikit
sjk	sejak
sj	saja
skalian	sekalian
skali	sekali
sklh	sekolah
skl	sekali
skrg	sekarang
skr	sekarang
skt	sakit
skul	sekolah
slalu	selalu
slameeet	selamat
slesai	selesai
slh	salah
sll	selalu
slma	selama
slm	salam
slmt	selamat
slsai	selesai
slt	sulit
sluruh	seluruh
smakin	semakin
sma	sama
smg	semoga
smp	sampai
smpt	sempat
sm	sama
smua	semua
smwny	semuanya
smw	semua
sndiri	sendiri
sndr	sendiri
sng	senang
sni	sini
snjata	senjata
socia	social
soft	halus
sohib	teman
so	jadi
soljum	sholat jumat
solusikah	solusi
solve	solusi
somse	sombong sekali
songong	sombong
sono	sana
soon	segera
sopo	siapa
sorga	surga
sorry	maaf
sory	maaf
sotoy	sok tahu
sowry	maaf
spa	siapa
sppa	siapa
sprti	seperti
spt	seperti
spy	supaya
srtfkt	sertifikat
ssuatu	sesuatu
stamp	stempel
statment	pernyataan
stay	tetap
stelah	setelah
stiap	setiap
still	masih
stlh	setelah
stock	stok
stop	henti
strain	varian
subbag	subbagian
successful	sukses
sue	sialan
suk	masuk
sumbangin	sumbangkan
sumpek	sempit
syantik	cantik
syg	sayang
syp	siapa
sy	saya
t4	tempat
tabanas	tabungan pembangunan nasional
tahi	kotoran
taik	kotoran
tai	kotoran
tajir	kaya
tak	tidak
tar	nanti
tauk	tahu
taun	tahun
tau	tahu
tawh	tahu
taw	tahu
tdak	tidak
tdi	tadi
tdk	tidak
td	tadi
tekor	rugi
telaah	telah
telat	terlambat
telkom	telekomunikasi
telmi	telat berpikir
telp	telepon
temen	teman
tenan	benar
tengil	menyebalkan
tengok	menjenguk
tentng	tentang
tepar	terkapar
terbitin	terbitkan
terjd	terjadi
terselah	terserah
teruss	terus
tetek	segala
tetep	tetap
te was	tewas
tggu	tunggu
tgl	tinggal
tgu	tunggu
thanks	terima kasih
thankz	terima kasih
thdp	terhadap
thd	terhadap
thinking	pemikiran
this	ini
thn	tahun
th	tahun
thx	terima kasih
tilang	bukti pelanggaran
tilep	tilap
tioghoa	tionghoa
tipi	tv
tipiwan	tvne
tirani	tiran
tkg	tukang
tks	terima kasih
tlah	telah
tlh	telah
tll	terlalu
tlpn	telepon
tlp	telepon
tls	tulis
tl	timeline
tman	teman
tmbah	tambah
tmbh	tambah
tmen	teman
tmn	teman
tmpah	tumpah
tmph	tumpah
tmpt	tempat
tnda	tanda
tngu	tunggu
tnh	tanah
tnyta	ternyata
togel	toto gelap
toh	kalau
tokai	tai
to	ke
tolol	bodoh
toserba	toko serba ada
toys	main
tpi	tetapi
tp	tetapi
tq	terima kasih
tracing	tracking
trdhulu	terdahulu
trending	trend
tren	trend
trgntg	tergantung
trial	uji coba
trima	terima kasih
trims	terima kasih
trimz	terima kasih
trlalu	terlalu
trm	terima
trnyt	ternyata
trs	terus
trus	terus
trutama	terutama
trz	terus
tsangka	tersangka
tsb	tersebut
tsk	tersangka
ts	penulis
tst	tahu sama tahu
ttd	tertanda
ttep	tetap
ttg	tentang
ttn	titan
ttp	tetap
tuch	tuh
tuhh	itu
tuh	itu
tuir	tua
tu	itu
tuku	beli
tuk	untuk
tuwh	tuh
twit	twitter
tw	tahu
tyap	tiap
uasai	kuasa
udah	sudah
uda	sudah
udh	sudah
ud	sudah
ui	universitas indonesia
ujg	ujung
ujicoba	uji coba
ujug	tiba
ultah	ulang tahun
ul	ulangan
umuuuummmm 	umum
untk	untuk
un tuk	untuk
un	untuk
unyu	lucu
uplot	unggah
uppu	apa
urang	saya
urgent	penting
urg	saya
urine	urin
usah	perlu
usa	perlu
ush	perlu
utang	hutang
utip	kutip
utk	untuk
utul	ujian tertulis
u/	untuk
u	untuk
vaccine	vaksin
vaksincorona	vaksin corona
vaksinny	vaksinnya
valas	valuta asing
valid	sah
vasin	vaksin
vee	uang
victory	menang
viks	fix
vol	volume
wad	buat
waras	sehat
warming	perhatian
wa	saja
waspadalah	waspada
wat	buat
watuk	batuk
w/	dengan
we	kita
wektu	waktu
wes	sudah
why	mengapa
wk	tertawa
wkt	waktu
wkwkk	tertawa
wkwkkw	tertawa
wkwkwk	tertawa
wkwkwkwk	tertawa
wkwkw	tertawa
wong	orang
worry	cemas
w	saya
wtf	what the fuck
xixi	tertawa
xixixi	tertawa
x	kali
yaaa	iya
yaa	iya
yad	yang akan datang
yah	iya
ya	iya
yakinn	yakin
yak	iya
yapz	iya
yaudahahlh	ya sudahlah
yaudah	ya sudah
ybs	yang bersangkutan
yes	iya
ye	ya
yg	yang
yi	yaitu
y	kenapa
yl	yang lain
yng	yang
yoha	iya
yoi	iya
yo	iya
yok	ayo
you	kamu
yowes	ya sudah
yuk	ayo
yup	iya
ywdh	ya sudah
y	ya
zonk	bodoh
